Precinct,DEM,REP,NP,LPN,IAP,OTH,TOTAL
1000,187,262,245,1,33,12,740
1001,354,372,411,11,46,23,1217
1002,0,0,0,0,0,0,0
1003,0,0,0,0,0,0,0
1004,890,426,1260,20,87,48,2731
1005,707,513,714,13,87,35,2069
1006,752,540,1055,12,82,54,2495
1007,1260,700,1608,26,154,89,3837
1008,1402,948,2028,29,162,106,4675
1009,474,518,432,5,78,27,1534
1010,170,104,260,6,27,10,577
1011,92,48,91,1,12,7,251
1012,454,903,551,18,109,26,2061
1014,0,1,0,0,0,0,1
1015,940,814,1088,27,139,73,3081
1016,170,236,133,4,19,9,571
1038,926,722,1243,22,106,58,3077
1039,1093,1203,1301,9,164,90,3860
1063,501,482,545,9,80,43,1660
1067,44,90,81,2,11,2,230
1072,60,174,148,1,29,6,418
1074,576,951,1218,21,133,25,2924
1302,1542,1156,1870,29,181,115,4893
1304,1282,864,1591,27,154,68,3986
1307,738,672,875,16,94,45,2440
1318,779,438,946,20,93,60,2336
1327,953,560,1082,21,125,72,2813
1328,655,547,877,12,106,45,2242
1330,582,781,765,25,104,51,2308
1331,744,526,946,26,103,50,2395
1333,534,499,620,14,74,37,1778
1334,694,559,713,12,89,48,2115
1335,532,579,606,11,82,50,1860
1336,593,343,805,19,93,39,1892
1341,1057,889,1381,38,172,70,3607
1343,319,400,426,11,52,24,1232
1344,606,429,750,9,83,35,1912
1346,820,1029,891,18,167,45,2970
1348,703,578,976,17,133,51,2458
1349,711,513,989,21,114,59,2407
1351,1251,797,1547,31,161,86,3873
1352,559,444,681,11,93,36,1824
1353,1097,675,1608,26,144,65,3615
1354,1379,933,1658,29,171,96,4266
1356,840,615,974,25,102,39,2595
1361,0,0,3,0,0,0,3
1363,0,1,2,0,0,0,3
1368,851,561,1042,19,121,58,2652
1384,136,80,201,6,20,10,453
1389,438,411,572,17,66,40,1544
1390,1428,1233,2002,36,224,82,5005
1394,843,1233,1047,20,173,58,3374
1396,1205,999,1604,33,177,81,4099
1411,906,1060,1100,29,164,51,3310
1510,145,449,274,4,51,8,931
1514,534,882,821,25,116,40,2418
1517,770,1287,960,21,161,45,3244
1518,791,1094,785,14,132,44,2860
1525,749,792,820,14,130,32,2537
1550,284,425,323,4,47,15,1098
1553,0,0,0,0,0,0,0
1602,1007,662,1132,22,137,79,3039
1605,1380,719,1619,25,163,86,3992
1606,696,992,896,18,152,57,2811
1609,795,619,1035,20,94,45,2608
1613,969,657,978,26,110,68,2808
1614,670,515,807,8,108,41,2149
1619,847,655,1076,19,107,56,2760
1621,513,331,572,15,69,32,1532
1625,1140,693,1363,32,136,86,3450
1631,950,636,942,19,115,62,2724
1632,1026,599,1246,18,141,53,3083
1633,753,302,913,11,98,54,2131
1643,166,272,415,12,38,16,919
1645,1439,746,2057,32,200,103,4577
1651,1161,951,1472,17,142,86,3829
1653,850,416,973,15,92,65,2411
1660,745,617,801,21,125,44,2353
1664,389,405,433,4,60,22,1313
1665,1,1,0,0,0,0,2
1668,1444,1619,2017,47,261,143,5531
1669,1325,962,1730,23,180,96,4316
1671,2,16,6,0,1,0,25
1672,1093,1142,1486,31,210,75,4037
1674,472,722,566,9,98,31,1898
1677,944,870,1118,20,145,69,3166
1679,306,397,315,11,53,23,1105
1680,713,639,783,18,93,42,2288
1682,1295,921,1648,36,202,95,4197
1685,321,441,435,10,75,12,1294
1688,402,423,502,8,66,25,1426
1689,793,650,899,16,117,38,2513
1695,217,432,322,12,54,12,1049
1696,1031,915,1041,28,152,48,3215
1700,1185,1024,1318,30,183,63,3803
1702,710,695,1005,21,95,60,2586
1706,63,38,83,1,5,5,195
1712,890,1014,922,21,133,47,3027
1715,725,1229,679,5,126,26,2790
1717,889,1161,658,4,158,26,2896
1719,250,316,215,3,46,6,836
1732,2,1,2,0,0,0,5
1750,363,724,785,16,83,12,1983
1751,274,774,503,8,71,13,1643
1753,47,160,71,0,8,3,289
2000,0,0,0,0,0,0,0
2002,7,16,10,0,1,0,34
2003,400,259,455,9,53,29,1205
2004,576,387,537,10,74,33,1617
2005,837,669,771,21,93,40,2431
2007,170,256,190,9,20,9,654
2008,1238,996,1276,29,175,76,3790
2009,772,348,862,15,64,64,2125
2010,28,24,13,1,3,1,70
2011,588,377,562,16,59,39,1641
2012,0,2,2,0,0,0,4
2013,538,213,693,14,61,36,1555
2014,1418,639,1466,28,145,94,3790
2015,1150,562,1282,27,127,62,3210
2016,49,74,66,2,8,6,205
2017,0,0,1,0,0,1,2
2019,75,80,100,0,12,8,275
2020,1,0,0,0,0,0,1
2021,1519,641,1698,38,157,84,4137
2023,610,287,692,9,71,33,1702
2025,1024,424,1105,15,117,70,2755
2028,1194,574,1316,14,125,73,3296
2029,84,21,90,0,6,4,205
2030,651,309,733,13,87,37,1830
2032,585,240,560,13,69,27,1494
2033,967,706,1003,22,116,56,2870
2036,1386,604,1189,23,126,66,3394
2037,1183,1271,1227,31,162,78,3952
2040,23,19,23,0,1,0,66
2042,12,3,14,0,0,2,31
2045,188,146,210,2,19,4,569
2046,1330,665,1280,19,142,70,3506
2047,486,218,497,11,44,39,1295
2048,1304,1029,1307,17,180,76,3913
2049,842,694,793,19,97,51,2496
2051,914,1084,1044,13,140,44,3239
2052,12,56,21,3,3,1,96
2053,215,606,351,16,65,20,1273
2054,675,873,835,22,101,47,2553
2055,784,1392,982,23,149,55,3385
2056,40,85,45,1,4,1,176
2057,0,0,0,0,0,0,0
2059,0,0,0,0,0,0,0
2060,230,238,320,6,29,13,836
2061,0,0,0,0,0,0,0
2063,496,196,518,10,58,21,1299
2064,0,0,0,0,0,0,0
2065,530,636,633,13,97,37,1946
2066,53,107,55,3,12,0,230
2067,560,543,698,22,65,27,1915
2068,0,0,0,0,0,0,0
2069,0,0,0,0,0,0,0
2070,0,0,0,0,0,0,0
2072,104,152,99,2,17,3,377
2073,834,603,1047,19,133,49,2685
2074,1107,773,1263,29,131,62,3365
2075,0,0,0,0,0,0,0
2077,478,232,587,4,54,33,1388
2078,0,0,0,0,0,0,0
2079,55,181,95,2,14,4,351
2080,95,291,135,4,18,5,548
2081,25,27,20,0,4,0,76
2082,597,865,657,19,115,29,2282
2086,1066,539,1520,24,146,94,3389
2087,1550,675,1645,26,167,88,4151
2088,686,312,781,14,84,36,1913
2126,985,601,1081,18,132,52,2869
2352,1054,1282,936,24,188,46,3530
2356,0,0,0,0,0,0,0
2360,1195,430,961,11,113,67,2777
2371,588,378,548,13,69,19,1615
2372,1061,704,1061,15,122,57,3020
2384,200,120,239,5,34,6,604
2387,1077,639,1225,19,139,61,3160
2399,924,548,1015,17,94,63,2661
2417,184,105,484,8,44,12,837
2430,557,291,697,14,58,33,1650
2440,600,673,372,6,96,12,1759
2444,140,116,151,1,18,11,437
2445,203,108,266,2,22,10,611
2449,891,832,702,16,110,32,2583
2457,887,1065,1020,23,160,52,3207
2464,1210,788,940,7,125,53,3123
2465,815,1427,1606,12,163,48,4071
2466,397,778,726,9,87,27,2024
2468,0,0,0,0,0,0,0
2469,98,353,209,5,31,12,708
2473,196,1777,580,25,92,22,2692
2477,203,692,400,6,75,10,1386
2478,0,0,0,0,0,0,0
2479,1139,758,1374,29,126,46,3472
2480,430,290,403,12,55,25,1215
2486,0,0,0,0,0,0,0
2487,0,0,0,0,0,0,0
2488,0,0,0,0,0,0,0
2489,0,0,0,0,0,0,0
2501,8,30,16,0,2,0,56
2503,3,7,9,0,1,0,20
2511,351,155,376,3,31,20,936
2600,934,1070,1187,48,182,66,3487
2601,9,20,7,0,2,0,38
2602,36,58,31,0,7,1,133
2605,416,526,464,9,80,23,1518
2606,1369,715,1197,22,158,62,3523
2608,0,0,0,0,0,0,0
2611,722,667,958,18,113,43,2521
2612,0,0,0,0,0,0,0
2614,974,1115,1174,29,185,56,3533
2622,490,754,574,18,91,21,1948
2623,0,1,1,0,0,0,2
2625,0,3,2,0,0,0,5
2631,10,15,11,1,0,1,38
2632,41,44,13,1,6,2,107
2633,840,1076,883,14,151,48,3012
2641,1,0,0,0,0,0,1
2642,22,60,29,2,4,3,120
2643,534,903,564,11,109,24,2145
2644,656,1510,760,13,128,38,3105
2645,39,77,31,1,9,1,158
2651,1034,1066,1212,36,172,70,3590
2654,787,1102,708,19,113,30,2759
2662,772,933,922,19,135,44,2825
2663,592,1176,682,16,117,43,2626
2666,1451,1123,1750,34,184,118,4660
2673,40,124,69,1,7,3,244
2675,9,14,11,0,2,0,36
2676,12,13,9,0,2,1,37
2681,3,0,0,0,0,0,3
2682,768,1011,789,18,117,40,2743
2683,0,4,0,0,0,0,4
2684,5,21,9,0,3,0,38
2685,0,0,0,0,0,0,0
2691,9,25,10,0,0,0,44
2693,32,58,49,2,3,3,147
2694,1,0,2,0,0,0,3
2695,795,993,889,20,131,42,2870
2696,20,24,13,2,1,0,60
2700,747,729,779,12,93,50,2410
2703,1,2,3,0,0,0,6
2704,22,33,24,0,4,3,86
2706,0,1,1,0,0,0,2
2709,325,295,316,5,40,16,997
2710,1340,984,1402,29,186,76,4017
2711,566,673,642,16,94,41,2032
2715,1051,588,1045,20,119,50,2873
2717,727,327,743,12,62,52,1923
2720,286,113,418,3,29,19,868
2723,0,0,0,0,0,0,0
2724,3,0,1,0,0,0,4
2725,76,489,219,3,33,6,826
2726,270,1390,683,16,124,28,2511
2730,1218,594,1273,30,127,71,3313
2731,592,1007,1097,7,132,25,2860
2733,1246,544,1468,32,137,101,3528
2737,686,176,657,3,63,42,1627
2740,1038,425,1593,29,152,74,3311
2742,0,0,0,0,0,0,0
2743,1399,710,1366,15,129,93,3712
2746,528,273,584,10,69,39,1503
2751,65,35,96,3,6,10,215
2752,1282,395,1492,17,130,74,3390
2770,66,12,77,2,8,3,168
2775,725,1832,1299,9,205,22,4092
2776,625,1570,1207,12,186,31,3631
3000,965,456,1005,27,103,56,2612
3003,783,428,855,11,91,49,2217
3004,0,0,0,0,0,0,0
3005,1,1,0,0,0,0,2
3006,175,196,158,8,23,9,569
3007,1345,545,1486,26,129,80,3611
3009,1111,654,1324,20,164,94,3367
3011,912,750,1048,19,125,57,2911
3013,725,433,755,14,91,46,2064
3014,752,717,900,18,112,34,2533
3016,707,797,969,9,138,53,2673
3017,1107,941,1291,16,167,58,3580
3018,1080,987,1217,26,148,63,3521
3021,1018,957,1150,23,150,48,3346
3022,1099,1131,1248,26,167,68,3739
3027,1145,995,1381,33,166,81,3801
3030,1142,739,1531,28,149,66,3655
3033,100,39,157,5,14,8,323
3034,382,202,433,9,51,18,1095
3035,49,16,94,3,8,1,171
3036,468,507,386,7,65,12,1445
3037,1010,1162,683,13,155,26,3049
3038,99,49,156,1,10,8,323
3039,764,342,819,9,81,48,2063
3040,714,1054,578,7,121,22,2496
3041,93,22,104,1,10,6,236
3043,749,401,668,12,92,32,1954
3045,612,306,637,7,67,48,1677
3046,0,0,0,0,0,0,0
3047,1,5,3,0,1,0,10
3048,21,50,31,0,6,0,108
3050,345,806,408,13,92,28,1692
3051,4,2,5,0,3,1,15
3053,1,7,1,0,0,0,9
3054,0,0,0,0,0,0,0
3055,1025,895,1168,34,180,61,3363
3056,41,117,53,2,5,5,223
3057,186,409,170,4,40,12,821
3058,756,650,788,16,114,43,2367
3059,1058,1052,1287,39,198,57,3691
3061,247,117,376,6,37,19,802
3062,1067,870,1098,19,161,70,3285
3064,55,134,77,2,14,3,285
3065,16,8,13,0,3,1,41
3066,11,24,16,1,3,0,55
3067,26,59,40,6,0,0,131
3068,464,272,432,8,48,32,1256
3069,146,31,150,5,14,9,355
3070,5,4,3,0,1,1,14
3071,144,310,162,1,41,12,670
3072,35,39,32,0,8,1,115
3074,415,295,446,10,62,25,1253
3151,0,0,0,0,0,0,0
3152,25,43,27,0,3,2,100
3191,0,1,1,0,0,0,2
3217,665,583,777,12,89,46,2172
3361,675,500,630,7,90,40,1942
3363,805,1168,984,22,147,62,3188
3364,479,827,654,16,94,35,2105
3366,962,1163,1048,29,143,48,3393
3370,1165,999,1209,17,178,70,3638
3373,1294,1440,1418,40,198,82,4472
3374,883,981,986,25,165,58,3098
3382,712,855,797,23,145,37,2569
3383,774,1084,585,13,143,17,2616
3385,618,689,564,20,86,28,2005
3391,782,767,719,16,140,32,2456
3392,573,571,618,19,70,26,1877
3414,313,490,420,8,55,12,1298
3417,825,608,973,24,133,48,2611
3418,224,325,233,12,43,12,849
3433,2,0,0,0,0,0,2
3435,1127,901,1154,24,140,70,3416
3439,0,0,2,0,0,0,2
3457,2,2,1,0,0,0,5
3464,757,909,687,14,131,35,2533
3518,1,9,1,0,3,1,15
3532,4,20,11,0,0,1,36
3535,5,12,5,0,3,0,25
3537,0,0,0,0,0,0,0
3540,134,302,185,7,21,10,659
3544,404,558,448,10,83,34,1537
3545,0,0,0,0,0,0,0
3546,1348,1300,1754,47,193,81,4723
3547,675,862,692,21,118,40,2408
3552,0,0,0,0,0,0,0
3553,0,0,0,0,0,0,0
3557,697,745,886,21,143,53,2545
3559,0,1,3,0,0,0,4
3562,1,9,4,0,0,0,14
3564,52,149,82,2,10,3,298
3565,849,1077,1210,20,162,48,3366
3571,4,1,0,1,1,0,7
3574,0,0,0,0,0,0,0
3576,803,998,852,23,135,48,2859
3578,11,28,10,0,1,0,50
3579,3,7,4,0,1,0,15
3580,0,0,0,0,0,0,0
3581,0,1,0,0,0,0,1
3582,0,0,0,0,0,0,0
3583,482,610,650,18,109,17,1886
3584,0,3,3,0,0,0,6
3585,0,0,0,0,0,0,0
3586,0,0,0,0,0,0,0
3587,775,1034,924,26,147,40,2946
3588,971,1151,1174,40,163,48,3547
3602,831,848,854,23,131,51,2738
3604,1110,780,1354,26,153,79,3502
3605,150,434,372,16,46,16,1034
3606,1221,1191,1388,31,186,72,4089
3607,759,448,924,25,118,41,2315
3609,356,825,514,14,82,26,1817
3611,0,0,0,0,0,0,0
3612,0,0,0,0,0,0,0
3613,580,367,636,16,73,41,1713
3700,113,130,140,2,21,3,409
3705,355,480,454,9,63,15,1376
3706,1084,1242,1472,34,187,68,4087
3709,243,412,400,12,68,19,1154
3710,206,263,172,6,32,14,693
3712,0,2,0,0,0,0,2
3713,26,18,14,0,0,3,61
3714,14,20,16,0,2,0,52
3715,431,1073,447,15,112,25,2103
3716,1,1,2,0,0,0,4
3717,286,498,307,12,61,18,1182
3719,1271,1108,1354,36,191,79,4039
3724,1369,940,1440,25,179,76,4029
3725,3,6,3,0,0,0,12
3727,714,1037,534,6,113,23,2427
3729,418,464,457,14,53,27,1433
3730,762,589,881,22,137,45,2436
3731,0,3,6,0,0,0,9
3732,1052,905,1103,28,145,66,3299
3735,37,42,13,0,2,2,96
3736,7,31,9,1,2,0,50
3737,0,0,0,0,0,0,0
3740,1091,1681,1627,22,184,88,4693
3745,0,0,0,0,0,0,0
3747,893,739,881,16,137,39,2705
3748,766,948,783,17,119,40,2673
3750,0,0,3,0,0,0,3
3753,164,74,233,8,23,12,514
3754,1136,517,1385,26,112,70,3246
3755,846,579,872,29,92,43,2461
3757,281,591,305,5,54,19,1255
3758,63,189,90,2,19,7,370
3762,1165,700,1299,25,143,70,3402
3763,150,139,105,3,20,11,428
3764,1350,876,1489,32,176,74,3997
3765,825,433,942,21,106,48,2375
3766,732,897,789,16,104,39,2577
3767,4,34,7,0,2,1,48
3769,402,354,408,7,60,32,1263
3771,401,266,442,8,34,25,1176
3773,587,303,638,8,67,45,1648
3776,0,0,0,0,0,0,0
3777,0,4,3,1,0,0,8
3778,0,0,0,0,0,0,0
3779,0,0,0,0,0,0,0
3780,549,675,560,16,84,28,1912
3781,838,873,1012,32,134,65,2954
3786,7,14,9,0,2,1,33
3787,540,504,573,16,95,30,1758
3793,1249,1550,2001,26,231,76,5133
3800,1037,1058,1047,27,164,50,3383
3863,1138,786,1168,19,156,94,3361
3875,0,0,0,0,0,0,0
3881,0,0,0,0,0,0,0
4000,547,231,588,16,63,38,1483
4001,156,117,235,4,12,10,534
4002,51,46,53,2,4,4,160
4003,3,1,2,0,0,0,6
4004,0,0,0,0,0,0,0
4005,16,3,5,0,1,1,26
4006,10,20,29,2,2,1,64
4007,506,258,551,9,67,32,1423
4008,431,151,427,7,30,16,1062
4009,520,208,549,11,44,44,1376
4010,1268,819,1125,32,123,46,3413
4011,462,314,516,13,60,22,1387
4012,908,739,802,20,134,45,2648
4013,1667,739,1669,29,180,84,4368
4014,0,0,0,0,0,0,0
4015,0,0,0,0,0,0,0
4017,1590,233,1020,13,91,76,3023
4018,223,231,252,17,29,4,756
4019,1223,400,1553,24,174,92,3466
4020,711,325,890,27,101,40,2094
4021,462,279,442,15,41,28,1267
4022,872,448,897,12,95,46,2370
4024,1028,307,985,6,84,55,2465
4026,15,8,25,0,3,2,53
4027,923,350,1027,20,108,63,2491
4028,1296,192,983,10,107,71,2659
4030,1265,269,1125,20,163,101,2943
4031,160,29,223,2,23,10,447
4032,609,297,516,13,73,32,1540
4034,301,115,352,6,44,19,837
4035,569,175,728,8,49,35,1564
4036,1111,309,1015,19,73,59,2586
4037,574,146,746,10,57,35,1568
4038,0,0,0,0,0,0,0
4039,0,0,0,0,0,0,0
4040,491,230,658,15,110,54,1558
4041,0,0,0,0,0,0,0
4043,347,150,351,2,24,13,887
4044,1506,630,1525,23,167,77,3928
4045,257,109,248,7,36,11,668
4046,287,317,272,8,37,18,939
4069,72,27,120,3,12,8,242
4070,3,0,1,0,0,0,4
4073,24,14,9,1,2,2,52
4075,1,0,1,0,0,0,2
4076,4,2,4,1,1,2,14
4304,1767,533,1439,21,146,81,3987
4306,1074,276,854,12,58,48,2322
4309,672,134,527,9,39,29,1410
4387,1152,315,1151,22,65,47,2752
4400,1580,622,1467,26,161,83,3939
4401,4,2,2,0,0,1,9
4402,403,196,371,1,41,14,1026
4404,1473,596,1437,25,143,85,3759
4405,0,3,5,0,0,0,8
4406,1,1,0,0,0,0,2
4407,1,6,5,0,0,0,12
4408,2,0,1,0,0,0,3
4411,856,413,783,7,82,38,2179
4413,356,294,313,9,32,16,1020
4414,1250,758,1117,21,132,83,3361
4415,1095,252,1089,9,75,63,2583
4417,1278,743,1196,28,136,81,3462
4420,146,76,107,2,19,5,355
4421,1061,647,1025,13,106,63,2915
4422,1192,606,1092,23,108,72,3093
4423,1532,778,1349,32,151,84,3926
4434,54,61,93,2,23,3,236
4454,0,1,0,0,0,1,2
4458,0,0,0,0,0,1,1
4461,1145,198,784,12,90,48,2277
4463,143,51,151,6,26,16,393
4501,1642,863,1702,21,181,95,4504
4502,533,270,477,6,48,34,1368
4504,1113,390,1122,19,117,49,2810
4505,743,341,672,8,63,45,1872
4506,647,331,661,8,63,41,1751
4508,1778,312,1372,18,122,79,3681
4510,1223,810,1987,89,389,253,4751
4511,0,0,0,0,0,0,0
4512,1398,647,1346,19,126,76,3612
4526,1642,348,1183,19,132,83,3407
4528,983,271,948,11,99,64,2376
4529,1343,395,1525,21,138,64,3486
4540,512,108,551,9,54,26,1260
4541,1789,556,1910,16,168,98,4537
4543,1125,429,1455,27,157,88,3281
4547,1292,529,1601,29,200,104,3755
4548,1064,276,1127,14,108,70,2659
4550,305,87,376,6,24,23,821
4553,1007,264,1209,18,96,46,2640
4555,1846,554,2008,31,158,97,4694
4559,1021,348,1239,17,117,58,2800
4562,688,257,814,9,67,37,1872
4564,1144,367,1201,20,104,64,2900
4566,365,103,361,2,31,19,881
4573,178,50,258,2,20,13,521
4581,1709,663,1500,23,152,89,4136
4583,1496,544,1366,20,117,81,3624
4585,658,217,606,6,36,29,1552
4586,1724,670,1475,20,138,76,4103
4590,624,172,823,15,71,47,1752
4591,315,54,242,2,25,21,659
4597,1699,383,1866,20,127,101,4196
4605,485,272,707,17,98,35,1614
4609,1,2,0,1,0,1,5
4612,59,17,76,3,8,5,168
4613,169,60,250,6,24,4,513
4615,3,3,3,0,1,1,11
4623,681,513,670,17,72,39,1992
4633,865,442,838,10,109,49,2313
4638,214,57,173,7,20,14,485
4641,90,70,99,3,15,7,284
4645,0,0,1,0,0,0,1
4650,1116,243,1147,12,103,69,2690
4716,1023,431,1083,15,108,67,2727
5001,544,152,580,11,49,23,1359
5002,1239,340,1332,18,107,62,3098
5003,134,63,218,4,19,7,445
5005,1094,327,1062,13,80,70,2646
5007,975,335,1114,16,99,53,2592
5008,1147,415,1320,21,126,63,3092
5011,664,332,687,10,48,33,1774
5012,844,309,813,13,65,45,2089
5013,956,346,1094,9,77,84,2566
5014,0,0,0,0,0,0,0
5015,714,212,938,12,75,54,2005
5017,937,471,938,22,81,55,2504
5018,712,277,640,12,59,33,1733
5020,486,179,566,4,43,32,1310
5022,981,238,989,12,68,58,2346
5023,583,1079,833,24,142,39,2700
5024,591,1103,782,13,126,44,2659
5025,769,988,970,29,173,46,2975
5028,28,19,53,2,6,0,108
5029,773,357,917,18,109,48,2222
5030,890,507,1084,7,129,61,2678
5031,1114,373,1167,17,88,52,2811
5035,0,0,0,0,0,0,0
5037,696,1248,846,30,146,41,3007
5038,852,369,1022,19,62,59,2383
5039,85,29,124,0,10,5,253
5040,1015,468,1070,16,85,68,2722
5041,172,78,187,7,17,10,471
5042,273,200,275,4,25,24,801
5044,622,350,871,16,107,53,2019
5045,728,335,893,13,77,44,2090
5046,986,397,997,14,95,57,2546
5047,695,778,1109,33,152,61,2828
5048,77,41,125,2,13,7,265
5049,294,215,276,7,46,17,855
5050,1,0,0,0,0,0,1
5323,1313,501,1292,26,112,77,3321
5324,901,770,842,16,82,56,2667
5330,1226,583,1186,23,79,73,3170
5350,1574,572,1381,38,160,74,3799
5372,1019,402,1244,26,136,80,2907
5384,1004,345,788,21,104,45,2307
5395,299,261,265,4,44,10,883
5403,182,77,193,3,15,9,479
5405,1240,540,1330,17,126,86,3339
5412,1501,664,1439,12,114,81,3811
5417,992,514,974,24,85,54,2643
5425,1192,576,1207,25,133,63,3196
5500,0,0,0,0,0,0,0
5501,299,402,299,10,40,15,1065
5503,0,0,0,0,1,0,1
5504,993,719,839,16,99,47,2713
5506,0,0,0,0,0,0,0
5513,1182,643,1129,20,88,64,3126
5530,942,2301,1682,41,254,65,5285
5531,188,224,183,8,34,4,641
5533,965,586,725,17,101,51,2445
5539,1,0,0,0,0,0,1
5540,0,0,0,0,0,0,0
5542,429,163,453,6,35,21,1107
5543,308,93,465,6,35,20,927
5545,545,212,716,12,79,33,1597
5547,43,119,75,1,15,4,257
5550,221,395,271,3,46,14,950
5554,716,546,686,23,76,34,2081
5556,628,1204,879,18,156,57,2942
5560,925,610,892,22,95,42,2586
5561,1,1,1,0,0,0,3
5562,1,2,1,0,0,0,4
5563,876,327,951,18,74,49,2295
5565,929,417,947,29,83,39,2444
5566,1411,949,1298,32,183,69,3942
5569,1083,729,1036,28,138,64,3078
5570,1443,784,1611,21,202,81,4142
5571,753,369,948,21,101,48,2240
5572,977,460,1012,23,114,61,2647
5577,440,210,433,4,46,18,1151
5578,697,354,740,7,67,37,1902
5581,1101,351,1545,24,179,103,3303
5582,867,393,1203,19,145,72,2699
5583,798,297,1187,24,140,72,2518
5584,754,215,744,19,75,29,1836
5585,756,315,921,16,106,51,2165
5586,704,327,1032,23,146,57,2289
5587,1349,782,1418,27,178,79,3833
5589,191,236,490,8,54,10,989
5590,0,0,0,0,0,0,0
5591,362,203,468,5,53,23,1114
5593,954,536,946,23,91,50,2600
5597,1224,414,1446,25,128,82,3319
5603,420,292,441,11,55,17,1236
5612,1383,568,1421,14,100,99,3585
5615,147,116,217,4,21,11,516
5620,1310,600,1509,17,142,80,3658
5622,1064,503,1285,31,137,63,3083
5624,423,274,423,14,49,17,1200
5625,1424,727,1487,24,117,100,3879
5633,563,238,808,9,69,35,1722
5634,297,169,328,9,34,23,860
5635,783,344,902,7,76,48,2160
5652,290,638,373,11,64,13,1389
6000,19,39,18,1,1,0,78
6001,1680,1735,2491,44,271,132,6353
6003,343,504,259,3,64,9,1182
6004,488,710,407,2,97,11,1715
6007,704,717,864,15,136,45,2481
6009,559,530,700,12,81,45,1927
6011,386,266,486,14,67,20,1239
6012,366,352,439,7,36,25,1225
6013,31,14,52,0,3,1,101
6014,492,485,644,13,73,32,1739
6015,547,398,730,12,82,47,1816
6016,964,629,1168,23,139,80,3003
6017,1139,890,1203,18,161,53,3464
6018,252,499,384,8,49,27,1219
6019,0,0,0,0,0,0,0
6020,0,0,0,0,0,0,0
6021,0,0,0,0,0,0,0
6022,0,0,3,0,1,0,4
6023,0,1,0,0,0,0,1
6024,0,0,0,0,0,0,0
6025,0,0,0,0,0,0,0
6026,0,0,0,0,0,0,0
6027,0,0,0,0,0,0,0
6028,0,0,0,0,0,0,0
6030,509,336,532,7,54,28,1466
6031,491,288,519,10,56,25,1389
6032,374,224,487,6,49,19,1159
6033,788,541,1001,19,126,42,2517
6034,378,242,635,8,53,39,1355
6036,764,811,1117,22,125,48,2887
6037,743,662,942,11,108,61,2527
6038,614,442,805,14,73,41,1989
6039,0,2,0,0,0,0,2
6041,197,69,222,1,26,11,526
6042,1225,1213,1729,29,189,139,4524
6043,92,75,59,1,13,4,244
6044,917,573,1131,26,132,72,2851
6045,1036,812,1369,27,152,58,3454
6046,305,324,416,7,36,33,1121
6047,5,3,10,0,0,0,18
6057,767,459,983,18,104,57,2388
6062,779,639,829,13,97,54,2411
6066,1155,754,1471,17,138,78,3613
6154,818,1113,1068,23,167,61,3250
6155,0,0,0,0,0,0,0
6156,0,0,0,0,0,0,0
6157,0,0,0,0,0,0,0
6159,0,0,0,0,0,0,0
6161,0,1,0,0,0,0,1
6309,1,1,1,0,0,0,3
6365,2,2,0,0,0,0,4
6374,3,0,0,0,0,0,3
6375,0,0,0,0,0,0,0
6376,0,2,0,0,0,0,2
6377,1,0,3,0,0,0,4
6378,1,1,0,0,0,0,2
6379,0,0,0,0,0,0,0
6380,0,0,0,0,0,0,0
6381,0,2,0,0,0,0,2
6382,0,0,0,0,0,0,0
6385,0,1,0,0,0,0,1
6431,530,305,529,7,67,22,1460
6467,1317,1213,1702,26,180,91,4529
6468,872,748,1093,19,108,65,2905
6469,1308,1070,1563,16,189,83,4229
6471,662,392,716,13,101,48,1932
6487,253,508,431,11,77,17,1297
6488,72,75,165,7,15,7,341
6490,1012,1106,1239,20,166,67,3610
6492,1661,1360,2238,39,223,124,5645
6493,900,954,1024,21,152,65,3116
6496,0,0,1,0,0,0,1
6497,666,770,862,19,123,53,2493
6498,37,119,55,2,11,5,229
6499,910,715,1138,21,106,70,2960
6500,15,20,8,0,1,0,44
6509,435,645,466,14,77,22,1659
6512,469,1055,562,12,98,36,2232
6514,791,888,902,12,164,50,2807
6517,765,922,923,22,149,48,2829
6520,1019,1049,1041,21,165,56,3351
6522,521,652,542,12,105,25,1857
6526,585,797,476,12,97,15,1982
6527,894,1180,1213,26,179,67,3559
6528,630,873,790,14,133,35,2475
6530,1027,1017,1277,33,161,67,3582
6533,560,346,715,16,71,43,1751
6534,0,0,0,0,0,0,0
6538,950,771,1219,22,142,53,3157
6539,635,515,757,19,111,52,2089
6540,872,722,1070,25,153,59,2901
6543,0,0,0,0,0,0,0
6545,719,477,858,17,105,39,2215
6547,859,583,1105,21,129,65,2762
6552,296,377,358,7,46,13,1097
6600,515,730,804,12,99,37,2197
6609,1136,946,1579,26,187,91,3965
6610,843,1209,1263,24,145,65,3549
6625,647,748,700,15,85,33,2228
6632,440,414,427,10,61,22,1374
6648,1301,997,1832,38,192,86,4446
6652,758,795,891,9,151,39,2643
6656,473,454,674,9,70,34,1714
6657,552,585,842,12,110,41,2142
6658,951,959,1307,16,138,60,3431
6666,1010,1113,1378,31,160,78,3770
6673,25,35,22,0,3,0,85
6675,552,631,688,10,91,39,2011
6681,284,401,345,6,50,17,1103
6685,384,510,486,13,55,31,1479
6693,1065,765,1332,22,145,71,3400
6695,1212,956,1380,25,142,69,3784
6704,547,303,543,4,50,33,1480
6705,264,110,292,7,30,11,714
6706,890,502,1116,23,110,70,2711
6707,718,546,844,9,110,43,2270
6708,861,750,1058,28,104,50,2851
6710,1128,571,1785,24,133,85,3726
6711,0,0,1,0,0,0,1
6713,1235,903,1588,28,157,86,3997
6715,502,421,621,12,69,44,1669
6717,774,844,1039,28,116,48,2849
6718,1474,973,1962,26,147,107,4689
6719,695,681,902,19,108,49,2454
6722,0,0,3,0,0,0,3
6725,1202,1046,1649,25,168,92,4182
6727,375,454,296,3,63,11,1202
6728,730,1358,890,20,150,43,3191
6731,1039,984,1258,27,159,75,3542
6734,308,336,447,9,46,20,1166
6735,1139,992,1459,31,168,84,3873
6736,396,298,459,16,52,24,1245
6738,1201,989,1431,32,191,88,3932
6741,740,999,774,21,131,29,2694
6742,436,547,337,6,59,17,1402
6750,583,465,692,14,62,45,1861
6751,793,666,986,21,113,78,2657
6753,1119,1152,1362,38,199,85,3955
7001,854,493,795,18,101,48,2309
7003,542,304,606,9,90,23,1574
7004,488,384,572,11,81,39,1575
7006,353,296,435,6,57,24,1171
7007,630,498,557,10,95,20,1810
7010,0,0,0,0,0,0,0
7011,43,38,67,1,9,4,162
7012,1272,663,1610,35,170,63,3813
7014,0,0,0,0,0,0,0
7015,176,193,297,7,31,11,715
7017,314,370,466,8,58,13,1229
7019,699,909,907,19,132,46,2712
7021,662,363,731,6,92,44,1898
7022,642,245,876,7,88,51,1909
7023,850,459,811,12,88,45,2265
7024,554,868,678,13,105,33,2251
7025,341,231,524,14,61,35,1206
7028,1289,693,1903,34,197,108,4224
7029,1057,822,1047,24,137,60,3147
7030,207,125,283,4,32,15,666
7032,209,244,185,2,23,10,673
7034,156,85,171,0,17,6,435
7036,1000,908,1490,22,164,90,3674
7037,663,445,765,9,87,47,2016
7039,848,1084,1245,36,173,52,3438
7040,580,905,816,25,136,35,2497
7041,512,837,641,15,123,38,2166
7042,639,633,766,21,124,43,2226
7043,1,0,0,0,0,0,1
7044,166,172,201,5,18,11,573
7045,0,0,0,0,0,0,0
7046,0,0,0,0,0,0,0
7047,1002,734,1008,23,136,55,2958
7051,0,0,0,0,0,0,0
7052,37,9,53,2,4,1,106
7053,295,151,251,7,36,15,755
7055,1397,735,1786,41,200,112,4271
7056,824,742,1126,24,149,54,2919
7057,386,423,514,8,88,21,1440
7058,334,297,384,12,53,15,1095
7059,833,941,863,18,141,48,2844
7060,893,749,1031,17,93,55,2838
7061,0,0,0,0,0,0,0
7079,987,447,1356,20,119,76,3005
7097,537,270,718,7,75,37,1644
7099,0,0,0,0,0,0,0
7311,373,204,375,9,53,24,1038
7312,1049,438,1317,27,155,94,3080
7332,1195,544,1213,14,123,96,3185
7334,477,311,554,10,59,27,1438
7341,1168,788,1387,34,180,82,3639
7352,943,1381,1098,30,207,56,3715
7355,758,847,983,26,134,45,2793
7361,422,691,623,12,96,43,1887
7366,1820,1540,2656,52,294,132,6494
7378,1015,1385,1084,16,179,67,3746
7402,1148,974,1268,31,164,81,3666
7403,1386,1258,1465,41,199,69,4418
7405,550,547,594,17,98,36,1842
7410,429,478,510,22,75,32,1546
7411,1019,748,1134,35,141,50,3127
7413,0,0,0,0,0,0,0
7414,871,747,1023,19,147,50,2857
7415,1222,1079,1313,27,162,65,3868
7417,1131,934,1505,40,152,80,3842
7430,715,666,1013,10,149,71,2624
7500,789,584,984,23,91,55,2526
7501,174,106,340,8,40,13,681
7502,511,437,937,21,101,46,2053
7503,287,141,456,12,51,24,971
7507,847,497,824,21,78,32,2299
7509,551,237,641,20,77,42,1568
7512,320,203,308,5,42,24,902
7513,1018,449,1095,14,106,57,2739
7514,0,0,0,0,0,0,0
7515,1040,776,979,19,116,59,2989
7522,1559,771,1920,27,165,118,4560
7523,206,117,132,0,19,7,481
7524,559,265,754,10,84,38,1710
7526,330,155,315,7,24,17,848
7527,484,239,790,16,86,56,1671
7528,842,414,989,19,97,49,2410
7531,542,282,688,15,72,47,1646
7542,11,23,19,1,2,0,56
7545,522,1383,669,23,161,27,2785
7552,526,1227,697,30,142,30,2652
7553,863,1713,1146,41,224,59,4046
7562,656,1755,908,40,199,38,3596
7569,1025,913,1236,26,148,55,3403
7570,849,801,1244,36,158,57,3145
7582,271,358,346,12,57,13,1057
7592,1102,1518,1497,35,218,81,4451
7595,192,666,282,13,48,8,1209
7601,845,1701,1102,34,186,50,3918
7603,536,1065,727,19,126,32,2505
7604,790,1281,931,30,184,46,3262
7611,1067,1583,1299,30,226,60,4265
7614,1044,1164,1288,29,180,81,3786
7622,232,234,304,13,40,10,833
7624,621,518,803,23,91,37,2093
7625,930,1201,1155,11,145,44,3486
7634,511,652,616,10,108,29,1926
7641,569,751,429,4,96,14,1863
7643,622,802,694,20,109,34,2281
7651,763,796,776,17,116,37,2505
7652,426,621,545,15,90,27,1724
7654,37,29,41,0,11,1,119
7663,357,321,359,5,49,17,1108
7665,1108,1139,1181,29,190,46,3693
7674,460,600,516,15,73,21,1685
7675,298,375,333,4,51,9,1070
7683,545,573,499,11,84,31,1743
7684,794,644,779,17,118,35,2387
7691,667,868,737,21,89,36,2418
7705,383,524,491,15,53,18,1484
7707,164,163,129,4,21,6,487
7714,452,272,631,12,58,28,1453
7715,724,584,804,20,79,48,2259
7723,725,506,779,21,92,49,2172
7726,311,150,429,8,37,7,942
7730,963,821,1037,22,139,53,3035
7745,1,0,0,0,0,0,1
9995,0,0,0,0,0,0,0
9996,2,5,18,0,1,0,26
